XXXXXXXXXXXXXXX
XP            X
X  WWWWW   W  X
X      W   W  X
X      W   W  X
X      W   W  X
X      W   W  X
X  WWWW WWWW  X
X  W   W      X
X  W   W      X
X  W   W      X
X  W   W      X
X  W   WWWWW  X
X            CX
XXXXXXXXXXXXXXX