XXXXXXXXXXXXXXX
XP WWWWWWWWWWWX
X  WWWWWWWWWWWX
XW  WWWWWWWWWWX
XWW  WWWWWWWWWX
XWWW  WWWWWWWWX
XWWWW  WWWWWWWX
XWWWWW  WWWWWWX
XWWWWWW  WWWWWX
XWWWWWWW  WWWWX
XWWWWWWWW  WWWX
XWWWWWWWWW  WWX
XWWWWWWWWWW   X
XWWWWWWWWWWW CX
XXXXXXXXXXXXXXX