XXXXXXXXXXXXXXX
XP WWWWWWWWWWWX
X  WWWWWWWWWWWX
XWWWWWWWWWWWWWX
XWW WWWWWWW WWX
XWW WWWWWWW WWX
XWW WWWWWWW WWX
XWWWWWWWWWWWWWX
XWWWWWWWWWWWWWX
XWW WWWWWWW WWX
XWWW  WWW  WWWX
XWWWWW   WWWWWX
XWWWWWWWWWWW  X
XWWWWWWWWWWW CX
XXXXXXXXXXXXXXX