XXXXXXXXXXXXXXX
XP WWWWWWWWWWWX
X  WWWWWWWWWWWX
XWWWWWWWWWWWWWX
XWWW       WWWX
XWWW WWWWW WWWX
XWWW WWWWW WWWX
XWWW WWWWW WWWX
XWWW WWWWW WWWX
XWWW WWWWW WWWX
XWWW       WWWX
XWWWWWWWWWWWWWX
XWWWWWWWWWWW  X
XWWWWWWWWWWW CX
XXXXXXXXXXXXXXX