XXXXXXXXXXXXXXX
XP WWWWWWWWWWWX
X  WWWWWWWWWWWX
XWWWWWWWWWWWWWX
XWWW       WWWX
XWW WWWWWWW WWX
XW WWWWWWWWW WX
X WWWWWWWWWWW X
XW WWWWWWWWW WX
XWW WWWWWWW WWX
XWWW       WWWX
XWWWWWWWWWWWWWX
XWWWWWWWWWWW  X
XWWWWWWWWWWW CX
XXXXXXXXXXXXXXX