XXXXXXXXXXXXXXX
XP WWWWWWWWWWWX
X  WWWWWWWWWWWX
XWWWWWWWWWWWWWX
XWWWWWWWWWWWWWX
XWWWWWWWWWWWWWX
XWWWWWWWWWWWWWX
XWWWWWWWWWWWWWX
XWWWWWWWWWWWWWX
XWWWWWWWWWWWWWX
XWWWWWWWWWWWWWX
XWWWWWWWWWWWWWX
XWWWWWWWWWWW  X
XWWWWWWWWWWW CX
XXXXXXXXXXXXXXX