XXXXXXXXXXXXXXX
XP WWWWWWWWWWWX
X  WWWWWWWWWWWX
XWWWWWWWWWWWWWX
XWW WWWWWWW WWX
XWWW WWWWW WWWX
XWWWW WWW WWWWX
XWWWWW   WWWWWX
XWWWW WWW WWWWX
XWWW WWWWW WWWX
XWW WWWWWWW WWX
XWWWWWWWWWWWWWX
XWWWWWWWWWWW  X
XWWWWWWWWWWW CX
XXXXXXXXXXXXXXX